10 5
¨        T
 -#-------
 P#     G 
----------
@@@@@@@@@@