10 5
¨        T
 -#----#--
 P#  T # G
----------
@@@@@@@@@@